E S E O O
E E E O O
O O E O O
E E E E O
O O E E F
